######################
#   #   ## ##        #
            ##########
# #    ##  #### ### ##
# #   # # ##    ###  #
#          ##  ##  # #
##### # #      ##  # #
##### ###  # #  ##   #
#          # #  # #  #
##### #  # # #     # #
######################